NO ./textures/swastika.xpm
SO    ./textures/wall_wolfenstein_1.xpm
WE       ./textures/wall_wolfenstein_3.xpm
EA                    ./textures/tnt.xpm

F          113, 127, 143
C   71, 47, 47    

11111
11001
 1211
1W001
 1011
  1



